1111111111111111111
1000E00000C00000P01
1101001101100011111
1100101000010100001
1111111111111111111