1111111111111111111
1E00000000C000000P1
1101001101100011111
1100101000010100001
1111111111111111111